. . . . . . . . . . . . . . . . . . . . . . . . . . . . .
. . + - - - - + - - - - - + . . + - - - - - + - - - - + .
. . | . . . . | . . . . . | . . | . . . . . | . . . . | .
. . | . . . . | . . . . . | . . | . . . . . | . . . . | .
. . | . . . . | . . . . . | . . | . . . . . | . . . . | .
. . + - - - - + - - + - - + - - + - - + - - + - - - - + .
. . | . . . . | . . | . . . . . . . . | . . | . . . . | .
. . | . . . . | . . | . . . . . . . . | . . | . . . . | .
. . + - - - - + . . + - - + . . + - - + . . + - - - - + .
. . . . . . . | . . . . . | . . | . . . . . | . . . . . .
. , , , , , . | . . . . . | . . | . . . . . | . , , , , ,
. , , , , , . | . . + - - + * * + - - + . . | . , , , , ,
. , , , , , . | . . | . . . p p . . . | . . | . , , , , ,
. . . . . . . | . . | . + , + + + , . | . . | . . . . . .
. , , , , , , + - - + . , , , , , , . + - - + , , , , , ,
. . . . . . . | . . | . + , + + + , . | . . | . . . . . .
. , , , , , . | . . | . . . . . . . . | . . | . , , , , ,
. , , , , , . | . . + - - - - - - - - + . . | . , , , , ,
. , , , , , . | . . | . . . . . . . . | . . | . , , , , ,
. . . . . . . | . . | . . . . . . . . | . . | . . . . . .
. . + - - - - + - - + - - + . . + - - + - - + - - - - + .
. . | . . . . | . . . . . | . . | . . . . . | . . . . | .
. . | . . . . | . . . . . | . . | . . . . . | . . . . | .
. . + - + . . + - - + - - + - - + - - + - - + . . + - + .
. . . . | . . | . . | . . . . . . . . | . . | . . | . . .
. . . . | . . | . . | . . . . . . . . | . . | . . | . . .
. . + - + - - + . . + - - + . . + - - + . . + - - + - + .
. . | . . . . . . . . . . | . . | . . . . . . . . . . | .
. . | . . . . . . . . . . | . . | . . . . . . . . . . | .
. . + - - - - - - - - - - + - - + - - - - - - - - - - + .
. . . . . . . . . . . . . . . . . . . . . . . . . . . . .
