. . . . . . . . . . . . . . . . . . . . . . . . . . . . .
. . + - - - - + - - - - - + . . + - - - - - + - - - - + .
. . | . . . . | . . . . . | . . | . . . . . | . . . . | .
. . | . . . . | . . . . . | . . | . . . . . | . . . . | .
. . | . . . . | . . . . . | . . | . . . . . | . . . . | .
. . + - - - - + - - + - - + - - + - - + - - + - - - - + .
. . | . . . . | . . | . . . . . . . . | . . | . . . . | .
. . | . . . . | . . | . . . . . . . . | . . | . . . . | .
. . + - - - - + . . + - - + . . + - - + . . + - - - - + .
. . . . . . . | . . . . . | . . | . . . . . | . . . . . .
. . . . . . . | . . . . . | . . | . . . . . | . . . . . .
. . . . . . . | . . + - - + - - + - - + . . | . . . . . .
. . . . . . . | . . | . . . * * . . . | . . | . . . . . .
. . . . . . . | . . | . , , , , , , . | . . | . . . . . .
. , , , , , , + - - + . , , , , , , . + - - + , , , , , ,
. . . . . . . | . . | . , , , , , , . | . . | . . . . . .
. . . . . . . | . . | . . . . . . . . | . . | . . . . . .
. . . . . . . | . . + - - - - - - - - + . . | . . . . . .
. . . . . . . | . . | . . . . . . . . | . . | . . . . . .
. . . . . . . | . . | . . . . . . . . | . . | . . . . . .
. . + - - - - + - - + - - + . . + - - + - - + - - - - + .
. . | . . . . | . . . . . | . . | . . . . . | . . . . | .
. . | . . . . | . . . . . | . . | . . . . . | . . . . | .
. . + - + . . + - - + - - + - - + - - + - - + . . + - + .
. . . . | . . | . . | . . . . . . . . | . . | . . | . . .
. . . . | . . | . . | . . . . . . . . | . . | . . | . . .
. . + - + - - + . . + - - + . . + - - + . . + - - + - + .
. . | . . . . . . . . . . | . . | . . . . . . . . . . | .
. . | . . . . . . . . . . | . . | . . . . . . . . . . | .
. . + - - - - - - - - - - + - - + - - - - - - - - - - + .
. . . . . . . . . . . . . . . . . . . . . . . . . . . . .
